0 0 0 0 0 0 0 0 0 0 0 0 0 0 3 3 3 0
0 0 0 0 0 0 0 0 0 0 0 0 0 3 5 4 3 0
0 0 6 0 0 0 0 0 0 0 0 0 3 5 4 5 3 0
0 0 0 0 0 7 0 0 0 0 0 3 5 4 5 3 0 0
0 0 0 0 0 0 0 0 0 0 3 5 4 5 3 0 0 0
0 0 0 0 0 0 0 0 0 3 5 4 5 3 0 0 0 0
0 0 0 3 3 0 0 0 3 5 4 5 3 0 0 0 0 0
0 0 0 3 4 3 0 3 5 4 5 3 0 0 0 0 0 0
0 0 0 0 3 4 3 5 4 5 3 0 0 0 0 0 0 0
0 0 0 0 3 4 3 4 5 3 0 0 0 0 0 0 0 0
0 0 0 0 0 3 4 3 3 0 0 0 0 0 9 0 0 0
0 0 0 0 1 2 3 4 4 3 0 0 0 0 0 0 0 0
0 0 0 1 2 1 0 3 3 4 3 0 0 0 0 0 0 0
0 3 3 2 1 0 0 0 0 3 3 0 0 0 0 0 0 0
0 3 4 3 0 0 0 0 0 0 0 0 0 0 0 0 0 0
0 3 3 3 0 0 0 8 0 0 0 0 0 0 0 0 0 0
0 0 0 0 0 0 0 0 0 0 0 0 0 0 0 0 0 0
0 0 0 0 0 0 0 0 0 0 0 0 0 0 0 0 0 0