0 0 0 0 0 3 3 3 3 3 0 0 0 0 0
0 0 0 0 3 5 4 4 4 4 3 1 2 0 0
0 0 0 0 0 3 3 3 3 4 4 2 1 0 0
0 0 0 0 0 0 0 0 0 1 5 4 3 0 0
0 0 0 0 0 0 0 0 1 2 1 4 4 3 0
0 0 0 0 0 0 0 1 2 1 0 3 4 3 0
0 0 0 0 0 0 1 2 1 0 0 3 4 3 0
0 0 0 0 0 1 2 1 0 0 0 3 4 3 0
0 0 0 0 1 2 1 0 0 0 0 3 4 3 0
0 0 0 1 2 1 0 0 0 0 0 0 3 0 0
0 0 1 2 1 0 0 0 0 0 0 0 0 0 0
0 1 2 1 0 0 0 0 0 0 0 0 0 0 0
0 2 1 0 0 0 0 0 0 0 0 0 0 0 0