0 0 0 0 0 0 0 0 0 0 3 3 3 0 0
0 0 0 0 0 0 0 0 0 3 5 5 4 3 0
0 0 0 0 0 0 0 0 3 5 4 4 5 3 0
0 0 0 0 0 0 0 3 5 4 4 4 5 3 0
0 0 0 0 0 0 0 0 1 4 4 5 3 0 0
0 0 0 0 0 0 0 1 2 1 5 3 0 0 0
0 0 0 0 0 0 1 2 1 0 3 0 0 0 0
0 0 0 0 0 1 2 1 0 0 0 0 0 0 0
0 0 0 0 1 2 1 0 0 0 0 0 0 0 0
0 0 0 1 2 1 0 0 0 0 0 0 0 0 0
0 1 1 2 1 0 0 0 0 0 0 0 0 0 0
0 1 2 1 0 0 0 0 0 0 0 0 0 0 0
0 0 1 1 0 0 0 0 0 0 0 0 0 0 0